[
{
		"Columns": 10,
		"Rows": 13,
		"Tiles": [
			4,1,1,4,1,1,4,1,1,4,1,1,4,
			2,0,0,2,0,0,2,0,0,2,0,0,2,
		  3,1,1,5,0,0,5,1,1,5,1,1,5,
			0,0,0,5,1,1,5,0,0,2,0,0,2,
		  4,1,1,5,0,0,2,0,0,5,1,1,3,
			2,0,0,5,1,1,5,1,1,5,0,0,0,
      2,0,0,2,0,0,2,0,0,5,1,1,4,
			5,1,1,5,1,1,5,1,1,5,0,0,2,
			2,0,0,2,0,0,2,0,0,2,0,0,2,
			3,1,1,1,1,1,1,1,1,1,1,1,1
		]
}
]