[
{
		"Rows": 8,
		"Columns": 8,
		"Tiles": [
			0,2,2,2,2,2,2,2,
			1,2,2,2,1,2,2,2,
			1,2,2,2,0,0,0,2,
			0,2,2,2,1,2,2,2,
			1,2,2,2,0,2,2,2,
			1,2,2,2,1,2,2,2,
			1,2,2,2,1,2,2,2,
			0,0,0,0,0,0,0,0
		]
}
]